101
101
OOOOOOOOOOOOOOOOOOOXOXOOOOOOOXOOOOOOOXOXOXOOOOOOOXOOOXOOOOOOOXOOOXOXOOOXOXOOOXOXOXOOOXOOOOOXOOOOOOOXO
XXXXXXOXOXOXXXXXOXXXOXOXOXOXOXOXXXXXOXOXOXXXOXXXXXXXOXXXXXXXOXOXXXOXOXOXOXOXXXOXOXOXOXOXOXOXOXXXXXOXO
OOOOOOOXOXOXOXOOOOOXOXOXOXOXOOOXOOOOOXOOOOOXOOOXOOOOOOOOOOOXOXOOOOOXOXOOOXOOOXOXOOOXOXOXOXOOOOOXOOOXO
XXXXOXOXXXOXOXXXXXXXOXOXXXOXXXXXOXXXXXXXOXXXXXOXXXXXOXXXOXXXOXOXOXOXXXOXXXOXXXOXXXXXOXOXXXXXXXXXXXOXO
OXOXOXOXOOOOOXOXOXOOOOOOOXOXOOOOOOOXOOOOOXOXOOOOOOOOOOOXOOOXOOOXOXOOOXOOOXOXOXOOOOOOOXOXOOOXOOOOOOOOO
OXOXOXXXXXXXXXOXOXXXOXXXXXOXXXXXOXXXOXOXXXOXOXOXXXOXXXXXOXOXOXXXXXXXXXXXOXOXOXOXXXOXOXOXOXXXOXOXOXOXO
OOOOOOOOOOOOOOOXOOOXOXOOOXOOOOOXOXOOOXOXOOOOOXOXOOOXOOOOOXOOOXOXOOOXOOOOOOOOOOOOOXOXOXOOOOOXOXOXOXOXO
XXXXOXXXXXXXOXXXOXOXOXOXXXXXOXOXXXOXXXXXXXXXXXOXXXXXXXOXXXOXXXOXOXOXXXXXXXXXOXXXOXXXXXXXXXOXXXXXXXXXO
OOOOOOOXOXOOOOOXOXOOOXOOOXOXOXOXOOOXOXOXOOOOOOOOOOOOOXOXOOOOOOOOOXOOOXOXOOOXOXOXOOOOOXOOOXOOOXOXOOOXO
OXXXOXXXOXXXOXXXOXXXOXOXXXOXOXXXOXXXOXOXOXXXXXXXOXXXXXXXXXXXOXXXXXXXXXOXXXOXXXOXOXXXXXOXXXOXOXOXOXXXO
OOOXOXOXOOOOOOOXOXOXOOOXOOOXOOOOOOOOOXOOOOOXOXOOOXOOOOOOOOOXOXOOOXOXOXOOOXOOOOOOOOOOOOOOOXOXOOOOOXOOO
XXOXXXOXXXOXOXOXOXOXXXOXOXXXXXOXOXOXXXOXXXXXOXXXOXOXXXXXXXXXOXXXOXOXOXOXOXXXXXOXOXXXOXXXOXOXXXOXOXXXX
OOOXOXOXOOOXOXOXOXOOOXOOOXOOOOOXOXOXOXOXOOOXOXOOOOOXOOOXOOOXOOOOOOOXOOOXOXOOOXOXOXOXOXOOOXOOOXOXOOOOO
XXOXOXOXXXOXXXXXXXOXXXOXXXXXXXOXXXOXOXOXOXXXOXXXXXOXOXXXOXXXXXXXXXXXOXOXXXXXOXXXXXOXOXXXXXOXOXOXOXXXX
OOOXOOOXOOOXOXOXOOOOOOOXOXOOOXOOOXOXOOOOOOOOOXOOOOOXOOOOOXOOOOOOOXOOOXOOOXOXOOOOOOOOOOOXOXOXOXOXOOOOO
XXOXOXOXXXOXOXOXOXXXXXXXOXOXOXXXXXXXOXOXOXXXXXOXOXOXOXOXXXXXOXOXXXOXXXXXXXOXOXOXXXOXXXXXOXXXOXXXOXXXO
OXOXOXOOOXOXOOOOOOOXOOOOOXOXOXOOOOOOOXOXOXOOOXOXOXOOOXOOOOOOOXOOOXOOOXOOOOOXOXOOOXOOOOOOOOOOOXOOOOOXO
OXXXOXXXOXOXOXOXXXXXXXXXOXOXXXXXXXOXOXOXXXOXOXXXXXOXXXXXXXXXOXXXXXXXOXOXXXOXXXXXOXXXXXXXXXXXXXXXOXXXO
OXOXOXOOOXOOOXOOOXOOOXOXOOOOOOOOOOOXOXOXOOOXOXOOOXOOOOOXOOOOOOOXOOOXOXOXOOOXOXOOOOOXOXOOOOOOOOOOOXOOO
OXOXOXXXOXXXXXOXXXXXOXOXXXOXXXOXOXXXXXXXXXXXOXXXOXXXXXXXXXXXOXOXOXOXOXOXXXOXOXXXXXXXOXOXOXXXOXXXOXXXX
OOOOOXOOOXOXOXOOOOOOOOOOOOOOOXOXOOOXOXOOOOOXOXOXOXOOOXOOOXOXOXOOOXOXOXOOOXOXOXOXOXOOOXOXOXOXOOOXOXOXO
OXOXXXOXXXOXOXOXXXXXXXXXXXXXOXOXOXOXOXXXOXOXOXOXOXOXXXOXXXOXOXXXOXXXOXOXXXOXOXOXOXOXXXXXOXOXOXOXXXOXO
OXOXOOOOOOOOOOOXOXOOOOOOOXOOOXOXOXOOOXOXOXOOOXOOOXOOOOOOOOOXOXOOOOOXOOOXOOOOOXOOOXOOOOOXOXOOOXOXOXOOO
XXXXXXXXOXXXXXXXOXXXOXXXXXXXOXOXXXOXOXOXXXXXOXXXOXOXXXXXXXXXXXOXXXOXOXOXXXOXXXXXOXXXXXOXOXXXXXXXOXOXX
OXOOOOOXOOOXOXOOOOOOOXOOOOOXOXOXOXOXOOOOOXOOOXOOOOOOOXOOOXOXOXOXOXOOOXOOOXOOOXOOOOOXOOOOOOOXOOOOOOOOO
OXOXXXOXXXXXOXXXXXOXOXXXXXOXXXOXOXXXXXXXXXOXOXXXOXOXOXXXOXOXOXXXOXOXOXXXOXXXOXXXOXXXOXXXOXXXXXOXOXOXO
OOOOOXOXOOOOOXOOOXOXOOOOOXOOOOOOOXOOOOOOOXOXOOOXOXOXOXOOOXOOOOOOOOOXOOOXOOOXOOOXOOOXOOOXOOOOOXOXOXOXO
XXXXOXXXOXOXXXOXOXXXOXOXXXOXXXXXXXOXXXXXOXOXXXXXXXOXOXOXXXOXXXOXOXXXXXXXXXXXXXXXXXOXOXOXOXXXXXOXOXXXO
OOOXOOOOOXOOOXOXOXOOOXOOOOOXOOOXOOOOOXOOOXOOOOOOOXOXOOOXOXOOOXOXOOOXOXOOOXOOOXOOOOOOOXOXOXOOOXOXOXOXO
OXOXXXXXOXXXOXXXOXXXOXOXOXXXOXXXOXXXOXXXXXOXOXOXOXXXXXOXOXXXXXXXXXOXOXXXOXXXOXXXXXOXXXOXXXXXOXOXXXOXO
OXOOOOOOOXOXOOOOOOOOOXOXOOOXOXOXOOOXOXOOOOOXOXOXOXOXOOOOOXOOOXOOOOOOOOOXOOOOOXOOOOOXOOOXOXOXOXOOOXOOO
OXXXXXOXXXOXXXOXXXXXOXXXXXXXOXOXOXXXOXXXXXOXXXOXOXOXXXOXXXXXOXOXXXXXOXXXOXXXXXOXXXXXXXOXOXOXOXOXOXXXX
OOOXOOOXOOOXOOOOOXOXOXOOOOOOOOOXOXOOOXOXOXOXOXOXOOOOOOOOOXOXOOOOOOOXOXOXOXOOOXOOOOOOOXOOOOOXOOOXOXOXO
XXXXXXOXOXOXXXOXXXOXOXXXOXXXOXXXXXXXOXOXOXOXOXOXXXOXXXXXOXOXOXXXOXXXOXOXOXXXOXOXXXOXXXXXXXOXXXOXXXOXO
OOOOOXOOOXOXOOOXOOOXOXOOOOOXOXOOOXOOOOOOOXOXOOOXOXOOOXOXOXOOOXOOOXOXOOOOOOOXOXOXOOOXOXOOOXOXOOOOOOOOO
XXOXOXXXXXXXXXXXOXOXOXOXXXXXOXOXOXXXOXXXOXXXXXXXOXXXOXOXXXXXOXOXXXOXXXXXOXXXOXOXXXXXOXOXXXXXXXOXXXOXX
OXOXOOOXOXOOOXOOOXOXOOOOOXOOOOOXOOOOOXOOOOOOOXOOOOOOOOOXOXOOOXOXOXOOOXOOOOOOOXOXOOOOOOOXOOOXOXOXOXOOO
OXOXXXOXOXXXOXXXOXXXXXOXXXXXXXXXXXXXXXXXOXXXXXOXXXXXXXOXOXXXOXXXOXOXOXXXOXXXXXOXXXXXXXOXOXXXOXOXOXXXX
OOOOOXOOOOOXOOOOOOOOOXOXOOOOOOOXOOOXOOOOOOOOOXOOOXOOOOOOOXOOOOOOOOOXOXOOOXOOOOOXOXOOOXOOOOOOOXOOOOOOO
XXOXXXXXOXOXOXXXOXOXXXOXXXOXXXOXOXXXOXOXOXXXXXXXXXXXOXOXXXXXXXOXXXXXOXXXOXOXXXOXOXXXOXXXXXXXOXOXXXXXO
OOOOOXOXOXOOOXOOOXOXOXOOOXOOOXOOOOOXOXOXOOOOOOOXOOOXOXOOOOOOOOOXOXOXOXOOOOOXOOOOOOOXOOOXOXOOOOOOOOOXO
OXXXXXOXXXXXOXXXXXXXOXXXOXOXXXXXOXOXXXOXOXXXXXXXOXXXXXXXOXXXOXXXOXOXXXOXXXOXXXOXXXOXOXOXOXOXOXOXXXXXO
OOOXOOOOOOOOOOOXOOOOOOOOOXOOOXOOOXOOOXOXOOOXOXOOOOOOOXOXOOOXOXOXOXOOOXOXOXOOOXOXOXOOOXOXOXOXOXOOOXOOO
XXXXXXXXXXXXOXXXXXXXOXXXOXXXOXOXXXOXXXXXXXOXOXXXOXXXXXOXXXOXXXOXOXOXOXXXOXOXXXOXOXOXOXXXOXOXXXOXXXXXO
OOOOOXOOOOOOOXOOOOOOOXOOOOOOOXOXOOOOOOOXOOOOOXOXOOOXOOOOOXOOOOOOOOOXOOOOOXOOOXOOOXOXOOOOOOOOOXOXOXOOO
XXXXOXXXXXXXOXXXXXOXOXOXOXOXOXXXXXXXXXXXXXOXXXOXOXXXXXOXXXXXXXXXOXOXXXXXXXXXXXXXXXXXXXOXOXOXXXOXOXXXO
OOOXOXOXOXOOOXOOOOOXOXOXOXOXOXOXOXOOOXOXOOOOOOOXOOOOOOOXOXOXOOOXOXOXOXOXOOOOOOOOOOOOOXOXOXOXOXOOOOOXO
OXOXOXOXOXOXXXOXXXOXXXXXOXOXOXOXOXOXOXOXXXOXOXOXOXOXXXOXOXOXXXOXOXXXOXOXXXXXOXXXOXOXXXOXOXOXOXXXXXXXX
OXOOOXOOOOOOOOOXOOOXOOOXOXOXOOOOOXOXOOOXOXOXOXOOOXOOOXOXOOOXOOOOOXOOOOOXOOOOOXOXOXOOOOOXOXOOOOOOOXOXO
XXOXOXXXOXXXXXOXXXOXOXXXXXXXOXXXXXXXOXXXOXOXXXXXXXXXOXXXOXOXXXXXOXXXOXOXOXXXOXOXXXOXXXXXOXXXXXOXXXOXO
OXOXOXOOOOOOOXOXOOOXOOOXOXOOOXOXOOOOOOOXOOOXOOOXOOOOOOOXOXOOOOOXOXOOOXOXOOOXOXOOOXOOOXOXOXOOOOOOOOOOO
OXOXXXOXXXOXOXOXOXOXOXOXOXXXXXOXOXOXXXXXOXXXOXXXXXOXXXOXXXXXXXOXXXXXOXXXXXXXOXOXOXXXXXOXXXXXXXOXOXXXX
OOOOOOOOOXOXOXOXOXOXOXOOOOOXOOOOOXOXOOOOOOOXOOOOOOOOOXOOOXOOOXOOOXOOOOOOOXOXOOOXOXOOOOOOOXOXOOOXOOOOO
OXXXXXOXXXOXOXXXXXXXOXOXXXOXXXOXXXOXOXOXXXOXXXOXOXXXOXOXOXOXOXOXXXXXOXXXXXOXXXOXXXXXXXOXOXOXXXXXOXXXO
OOOXOXOOOXOXOOOXOXOXOXOXOOOOOOOXOXOOOXOOOXOXOOOXOOOXOXOXOXOXOXOOOXOOOXOOOXOOOXOXOXOOOXOXOOOOOOOOOOOXO
XXXXOXXXXXOXXXOXOXOXXXXXXXOXOXOXOXXXXXXXXXOXXXOXXXOXXXOXXXOXOXOXXXOXXXXXOXOXXXXXOXXXOXOXXXXXOXXXXXXXO
OOOOOXOXOXOXOOOOOOOOOOOXOOOXOXOXOOOOOOOXOXOOOXOXOOOXOOOOOOOXOOOOOOOXOXOOOXOXOXOXOOOOOOOOOXOXOOOXOOOOO
XXOXXXOXOXOXOXOXXXXXXXXXXXOXXXXXOXOXXXOXOXXXOXXXOXXXOXXXOXXXXXXXXXXXOXOXXXOXOXOXOXXXXXOXXXOXXXXXOXXXX
OOOXOXOOOOOXOXOXOXOOOOOOOXOXOXOOOXOXOOOOOOOXOOOXOXOOOXOOOOOOOXOOOXOOOOOOOOOXOOOXOXOXOXOOOOOXOXOOOXOOO
XXOXOXXXXXOXOXOXOXOXXXOXXXXXOXOXXXOXXXXXXXXXOXXXXXXXOXOXOXOXXXXXOXXXOXXXOXXXOXOXXXOXOXOXOXXXOXOXOXXXO
OOOOOXOXOOOXOXOXOOOOOXOXOOOOOOOXOXOXOXOOOOOOOXOOOOOXOXOXOXOXOXOXOXOOOXOOOOOXOXOXOOOOOXOXOOOOOXOXOOOOO
OXXXOXOXOXXXXXXXOXOXXXOXOXOXXXOXOXXXOXXXXXOXXXXXOXXXOXOXXXXXOXOXOXOXXXOXOXXXXXOXXXOXXXXXXXOXXXXXXXXXX
OXOOOOOOOXOXOOOOOXOXOXOXOXOXOOOXOOOOOXOOOOOOOOOXOOOXOXOOOXOOOXOOOOOOOXOXOXOXOOOOOOOOOOOXOXOXOOOXOOOXO
OXOXXXOXOXOXOXOXXXOXOXOXOXXXXXOXOXOXXXXXOXXXXXOXOXXXOXXXXXXXOXOXOXXXXXXXOXOXXXOXXXXXXXOXOXXXOXXXXXOXO
OXOOOXOXOOOXOXOXOXOOOXOXOOOXOOOOOXOOOOOOOOOXOOOXOOOOOOOXOXOXOOOXOOOXOOOOOOOOOOOOOXOOOOOXOOOOOOOXOOOXO
XXXXOXXXOXXXOXOXOXXXXXXXOXXXXXXXXXOXXXXXXXOXOXXXXXOXXXXXOXOXOXXXXXXXXXOXOXXXXXOXXXXXXXOXOXXXXXOXXXOXO
OXOOOXOXOOOXOXOXOOOXOXOXOXOXOXOOOXOXOXOOOXOXOXOXOOOOOOOXOOOOOOOXOXOOOXOXOOOXOXOXOOOOOXOXOXOXOOOXOOOOO
OXOXOXOXXXXXOXXXXXOXOXOXXXOXOXOXXXXXOXXXOXXXOXOXXXXXOXOXOXOXOXXXOXOXXXXXOXXXOXOXOXOXXXOXOXOXXXXXOXXXX
OOOXOOOOOXOOOOOOOOOXOOOOOXOXOXOXOOOOOXOOOOOOOOOOOOOXOXOOOXOXOXOXOXOOOOOXOOOXOOOOOXOOOXOOOXOOOOOOOOOOO
OXXXXXXXOXOXOXXXXXOXXXOXOXOXOXOXXXXXOXOXOXXXOXXXOXXXOXXXXXOXOXOXOXOXOXOXOXOXXXXXXXOXOXXXXXOXXXOXXXXXX
OOOXOXOOOOOXOXOOOXOOOXOXOOOXOOOXOOOOOXOXOXOOOOOXOOOXOOOOOXOXOOOOOXOXOXOXOXOOOOOXOOOXOXOOOXOXOOOXOOOOO
XXXXOXOXOXOXXXXXOXXXXXOXOXXXXXOXOXXXOXXXXXXXXXXXXXXXOXXXXXXXOXXXXXOXOXXXXXXXOXXXXXXXOXOXOXXXOXXXOXXXX
OXOOOOOXOXOXOXOOOXOXOOOXOOOOOXOOOXOXOXOXOOOXOXOOOOOXOOOXOXOOOXOOOXOXOOOOOXOOOOOOOXOXOXOXOOOOOOOXOOOOO
OXOXXXOXXXXXOXOXXXOXXXXXXXOXXXOXOXOXXXOXXXOXOXXXOXXXXXXXOXXXXXXXOXOXOXOXXXOXXXXXOXOXOXXXOXXXOXOXXXOXX
OOOXOXOOOXOOOXOOOOOXOOOXOXOXOXOXOXOOOOOOOXOXOOOOOXOXOXOOOOOOOXOXOOOXOXOXOOOOOOOXOOOXOXOOOXOOOXOOOOOOO
OXXXOXOXXXXXOXOXXXXXOXXXOXOXOXOXXXOXOXXXXXOXOXXXOXOXOXXXXXXXOXOXXXOXXXOXXXXXXXXXOXOXOXOXXXXXOXXXXXOXX
OOOXOOOXOXOOOOOXOOOOOOOOOOOOOOOOOOOXOOOOOXOXOOOXOXOOOOOXOXOXOOOOOOOOOXOXOOOXOOOXOXOXOXOOOXOOOXOXOXOOO
XXXXXXOXOXXXXXOXOXOXOXOXXXXXXXXXOXXXXXXXOXOXXXOXXXXXOXXXOXOXXXXXOXOXXXXXXXOXOXOXOXOXOXOXXXXXXXOXOXOXX
OOOXOOOXOXOOOXOOOXOXOXOXOOOOOOOOOXOXOOOXOOOXOXOOOXOXOOOOOXOOOOOXOXOOOOOOOXOOOXOOOXOXOXOOOOOOOXOOOXOOO
OXOXXXOXOXOXXXXXXXOXXXXXXXXXOXXXOXOXOXOXXXOXOXOXXXOXXXXXOXOXXXOXXXOXXXOXOXXXXXOXXXOXXXOXOXOXOXXXOXXXO
OXOOOXOOOOOOOXOOOOOOOXOXOOOOOXOOOXOOOXOOOXOOOOOXOXOOOXOOOXOXOOOXOOOOOXOXOXOOOOOOOXOXOXOXOXOXOXOOOXOOO
XXOXXXOXOXOXXXOXXXOXXXOXXXXXOXXXOXXXOXXXOXXXOXXXOXOXXXOXXXXXOXXXOXOXOXOXXXXXXXXXOXXXOXXXXXOXOXOXOXXXX
OOOOOOOXOXOXOXOXOXOXOXOOOOOOOXOOOXOOOXOXOXOOOOOOOOOXOOOOOOOXOOOOOXOXOXOXOXOXOOOOOOOOOOOOOOOXOXOXOOOOO
OXOXOXOXXXXXOXXXOXOXOXOXOXXXXXOXXXXXOXOXOXOXXXXXXXXXXXOXOXXXXXOXXXXXXXXXOXOXOXXXOXXXOXXXOXOXXXXXOXXXX
OXOXOXOXOOOXOXOOOOOOOXOXOOOXOOOOOOOOOOOXOXOXOXOOOOOXOOOXOXOXOOOXOOOXOOOOOOOXOOOXOXOXOOOXOXOOOXOOOXOXO
OXXXXXXXOXXXOXOXXXOXXXXXOXXXXXXXXXXXXXXXXXXXOXXXXXOXOXXXOXOXOXXXXXOXOXXXXXXXOXXXXXOXOXXXXXOXXXOXXXOXO
OXOOOXOOOXOOOOOXOXOOOXOOOXOOOOOXOOOXOOOOOOOXOXOXOOOOOOOXOOOOOOOOOOOOOOOOOOOOOXOOOXOOOOOXOXOOOXOOOOOOO
OXOXOXOXXXXXOXXXOXOXXXXXOXOXXXXXOXXXOXXXOXXXOXOXOXXXOXOXXXOXXXOXOXXXXXXXXXXXOXOXXXXXXXXXOXOXXXOXOXXXX
OOOXOOOXOXOXOXOXOOOOOXOOOXOXOXOXOOOXOXOOOOOOOOOXOXOOOXOXOOOXOOOXOXOXOXOOOOOOOOOXOOOOOOOOOOOXOXOXOOOXO
OXXXOXOXOXOXOXOXXXXXXXXXOXOXOXOXXXOXXXXXXXOXOXXXXXOXXXXXXXXXOXOXXXOXOXXXOXOXXXOXXXXXXXXXXXXXOXOXXXOXO
OOOXOXOOOXOOOOOOOXOXOOOXOXOOOXOOOOOXOOOOOOOXOOOOOXOOOOOXOOOOOXOXOOOXOXOXOXOXOOOOOOOOOOOOOOOXOXOXOXOXO
OXXXXXXXXXOXOXXXXXOXOXOXXXOXXXXXOXOXOXXXOXXXOXXXXXOXXXOXXXOXXXXXXXOXOXOXXXXXXXOXXXOXOXXXOXXXOXXXOXOXO
OOOOOXOOOXOXOOOXOOOXOXOXOXOOOOOOOXOOOOOXOXOXOOOOOOOXOOOOOXOXOOOOOOOOOXOOOOOOOOOOOXOXOOOXOOOXOOOOOOOOO
XXXXXXXXOXXXOXXXXXOXOXXXOXOXXXXXXXXXOXXXOXOXXXOXXXXXOXXXXXOXXXXXXXOXXXOXOXXXOXXXXXOXOXXXXXOXOXOXOXXXO
OOOOOXOOOOOOOOOOOOOOOOOOOOOXOOOOOOOXOOOXOXOXOOOXOOOXOOOOOXOOOXOXOOOOOOOXOXOOOXOOOOOXOXOXOXOXOXOXOOOXO
XXOXXXXXOXXXOXXXOXXXXXXXOXXXOXXXXXXXOXXXXXOXXXOXOXOXOXXXOXXXOXOXXXXXXXOXOXOXXXXXXXXXOXOXOXOXOXXXXXOXX
OXOOOXOOOXOOOXOOOOOOOOOXOOOXOXOOOXOOOOOXOOOOOOOXOXOXOXOXOXOXOOOXOOOXOOOXOXOOOXOOOXOOOXOOOXOXOOOOOXOOO
OXXXOXOXXXOXXXOXXXXXXXOXXXOXOXOXXXOXXXXXOXXXXXOXXXOXOXOXXXOXOXOXXXOXXXOXXXXXOXXXOXOXXXXXOXOXOXXXXXXXX
OOOXOOOOOXOOOXOOOOOXOXOXOOOOOOOOOXOXOXOOOXOOOOOXOOOOOOOOOOOXOXOXOXOOOOOXOOOOOXOOOOOXOOOXOOOOOXOOOOOXO
OXOXXXOXXXXXXXOXOXXXOXXXXXXXOXXXOXOXOXOXOXOXXXXXOXXXOXOXXXOXOXXXOXXXXXXXXXOXXXXXXXOXXXOXXXOXXXXXXXOXO
OXOOOOOXOOOOOOOXOOOOOOOOOXOOOOOXOXOXOOOXOXOXOOOOOXOOOXOXOOOXOOOXOOOOOOOOOOOOOOOOOXOXOOOOOOOOOOOOOOOOOZ
