101
101
OOOXOOOXOOOXOOOOOXOOOOOOOXOOOXOXOOOXOOOOOXOXOOOXOOOOOXOXOOOXOXOXOOOOOOOOOOOOOXOOOXOOOXOOOXOXOXOXOOOOO
OXOXOXXXOXXXXXXXOXOXXXOXOXOXOXOXXXOXXXXXOXOXOXXXXXOXXXOXXXOXOXOXXXOXXXXXOXOXXXXXOXXXOXOXXXOXOXOXXXXXO
OXOXOXOOOOOOOXOOOOOOOXOXOXOXOXOXOOOXOOOOOOOOOOOXOXOOOXOXOOOXOOOOOXOXOXOXOXOOOOOXOOOXOXOOOXOXOXOXOOOOO
OXXXOXXXOXXXXXXXXXOXXXXXXXOXXXOXXXOXXXXXOXXXOXXXOXOXOXOXXXOXXXOXOXXXOXOXXXXXOXXXOXXXOXXXOXOXOXOXXXXXO
OXOOOXOOOOOXOOOOOXOXOOOOOOOOOXOXOOOXOXOXOXOOOXOOOXOXOXOOOOOXOXOXOXOOOXOXOOOOOXOOOXOOOXOOOOOOOXOXOOOOO
OXXXOXXXOXXXXXXXOXOXXXXXXXOXOXOXXXOXOXOXXXXXOXOXOXOXXXXXXXOXOXOXXXXXOXOXXXXXOXXXOXOXOXOXOXOXXXOXXXOXX
OOOOOXOOOOOOOOOXOOOOOXOOOXOXOOOOOXOOOOOXOXOOOOOXOXOOOXOOOXOOOOOXOOOXOXOOOXOXOOOXOXOXOOOXOXOXOOOOOOOXO
XXOXOXOXXXXXXXXXXXOXOXOXXXXXOXXXXXOXOXXXOXXXXXOXXXXXOXOXXXXXXXOXOXXXOXOXXXOXOXOXOXXXXXOXXXOXXXOXXXXXO
OOOXOOOXOXOXOOOXOXOXOOOOOOOOOXOOOXOXOXOOOOOOOOOXOOOXOOOXOXOOOOOOOXOXOXOOOXOOOXOXOXOXOOOXOXOXOOOXOOOOO
OXXXXXOXOXOXXXOXOXXXXXXXXXXXOXOXXXOXXXXXOXXXXXOXOXXXOXXXOXXXXXOXXXOXOXOXXXXXOXXXOXOXOXXXOXXXXXOXOXOXX
OXOXOXOXOXOXOOOOOOOOOOOOOOOXOOOXOOOOOOOXOXOXOOOOOXOOOOOXOOOOOOOOOXOOOOOXOOOOOOOOOXOOOXOOOOOOOOOOOXOXO
XXOXOXOXOXOXXXXXXXXXXXXXXXOXOXOXXXOXOXXXXXOXOXXXOXOXXXXXOXOXOXOXXXXXOXXXOXOXOXXXOXXXOXXXOXXXXXXXOXOXO
OOOOOXOXOXOOOOOXOOOOOXOOOXOXOXOXOOOXOOOXOOOOOXOOOOOOOXOOOXOXOXOOOOOXOXOOOXOXOXOOOXOXOOOOOOOXOXOXOXOXO
XXXXOXOXOXOXXXXXXXXXOXXXOXOXOXXXOXXXXXOXXXXXXXXXXXOXOXXXXXXXXXXXOXXXOXXXXXXXOXXXXXOXOXXXOXOXOXOXXXXXO
OXOXOXOOOXOOOOOOOXOOOXOOOOOXOXOXOOOXOXOXOXOXOOOXOOOXOXOOOOOOOXOXOXOXOXOOOXOOOXOOOOOXOXOXOXOXOOOOOOOXO
OXOXOXXXOXOXXXXXXXXXOXXXOXOXOXOXOXXXOXXXOXOXXXOXXXOXOXXXOXOXXXOXOXOXOXOXXXXXOXXXXXOXOXOXXXXXOXXXXXXXO
OXOOOOOXOOOXOXOXOOOOOOOOOXOOOOOXOOOXOOOXOOOOOOOXOXOXOXOOOXOOOOOXOXOOOOOXOOOOOOOXOOOXOOOOOXOOOXOXOXOOO
OXXXOXXXOXOXOXOXXXXXOXXXXXXXOXOXXXOXXXOXOXXXXXOXOXXXOXXXXXXXXXOXOXOXXXOXXXXXXXOXXXOXOXXXXXXXOXOXOXOXX
OOOOOOOOOXOXOXOOOXOXOOOXOOOXOXOXOXOXOXOXOXOXOXOOOXOOOXOXOOOXOOOOOXOXOOOOOOOOOXOXOXOOOXOOOOOOOXOXOXOXO
XXXXOXXXOXXXOXOXXXOXXXOXXXOXOXXXOXOXOXOXXXOXOXOXXXXXOXOXOXXXXXOXXXXXOXOXXXXXXXOXOXOXXXOXXXXXXXOXOXOXO
OOOOOOOXOOOXOXOOOOOXOXOXOOOXOXOOOOOOOXOXOOOXOXOOOXOXOXOOOXOOOOOXOXOOOXOXOXOOOOOOOXOOOOOOOOOXOOOOOXOXO
OXXXXXXXXXXXOXOXXXOXOXXXXXOXOXXXXXXXOXOXXXOXOXOXXXOXOXXXOXXXXXOXOXXXOXOXOXXXXXXXOXOXXXXXXXXXXXXXOXOXO
OOOOOOOXOOOXOOOXOOOXOXOOOXOOOXOXOXOOOOOXOOOXOOOOOXOOOOOXOOOOOXOOOXOXOXOXOXOXOOOXOOOOOXOXOXOXOXOOOXOXO
OXXXXXXXOXXXOXXXXXXXOXXXOXOXOXOXOXXXXXOXXXOXOXOXOXXXXXOXXXOXOXXXOXOXOXXXOXOXXXOXOXXXXXOXOXOXOXXXOXOXO
OOOXOOOOOXOXOOOXOOOXOOOOOOOXOOOOOOOOOOOOOOOXOXOXOXOOOOOXOXOXOXOXOXOOOXOXOXOXOOOOOOOOOOOOOOOOOOOOOOOOO
OXXXOXXXXXOXOXXXOXXXXXXXXXOXXXOXOXOXXXXXXXOXOXXXXXXXOXOXOXXXOXOXOXOXXXOXOXOXXXXXOXXXOXOXOXOXXXOXOXOXX
OXOXOOOXOXOXOXOOOOOXOOOOOOOXOXOXOXOXOXOXOOOOOOOOOXOOOXOOOXOOOOOOOXOOOXOOOOOXOXOOOOOXOXOXOXOOOXOXOXOXO
OXOXOXXXOXOXOXXXOXXXOXOXXXOXOXXXXXOXOXOXXXOXOXOXXXXXXXOXXXXXOXOXOXOXXXOXXXXXOXXXOXXXXXXXXXXXXXXXXXXXO
OOOXOXOXOOOOOOOOOOOXOXOXOXOXOOOXOOOXOOOOOOOXOXOXOOOOOOOOOXOXOXOXOOOOOOOOOXOXOOOXOXOOOXOXOOOXOOOXOOOOO
OXOXOXOXXXXXXXXXOXXXXXXXOXXXXXOXXXXXXXXXOXOXXXXXXXOXXXXXOXOXXXXXXXOXXXXXXXOXOXXXOXXXOXOXOXXXOXXXXXOXX
OXOXOXOOOXOXOOOOOOOXOXOOOOOXOXOXOXOXOXOXOXOOOOOXOOOXOOOXOXOOOXOXOOOXOXOXOXOXOXOOOOOXOOOOOXOXOOOXOOOOO
OXXXOXOXXXOXXXXXXXOXOXXXOXOXOXOXOXOXOXOXXXXXOXXXXXXXXXOXOXOXXXOXOXOXOXOXOXOXOXXXOXOXOXXXXXOXOXXXXXOXX
OOOOOXOXOXOOOXOOOOOOOOOXOXOOOXOXOXOOOOOOOOOOOOOOOXOOOOOXOOOXOXOOOXOXOOOOOXOOOXOXOXOXOOOXOXOOOOOXOOOXO
OXXXOXOXOXOXXXXXXXOXXXOXXXXXOXOXOXXXXXXXXXXXXXOXXXXXXXOXXXOXOXXXOXXXXXOXXXXXOXOXOXXXOXXXOXXXOXXXXXOXO
OOOXOXOOOOOOOXOOOXOXOOOXOXOOOXOXOOOXOOOOOXOOOXOOOXOOOXOXOOOOOXOOOOOOOXOXOOOXOXOXOXOOOOOXOXOOOOOOOXOOO
OXOXOXOXXXOXXXXXOXOXXXXXOXOXOXOXOXXXXXOXXXXXOXOXXXXXOXOXOXXXOXXXOXXXXXOXOXXXOXOXOXXXOXXXOXOXOXOXOXOXO
OXOXOXOXOOOXOOOOOOOOOXOXOXOXOXOOOOOXOOOOOOOOOOOXOOOOOOOXOXOOOOOXOOOXOOOOOXOOOOOOOXOOOOOXOXOXOXOXOXOXO
OXXXOXOXXXXXXXXXXXXXOXOXOXXXOXXXOXOXXXOXXXXXOXOXXXXXOXXXXXXXOXXXOXXXXXXXOXXXXXOXXXXXOXOXOXOXXXXXXXOXX
OOOXOXOXOOOOOOOXOXOOOOOOOXOOOXOOOXOXOXOXOXOOOXOOOOOXOXOOOXOOOOOXOOOXOXOOOOOXOOOOOOOOOXOOOXOOOXOOOOOOO
OXXXXXOXXXOXXXXXOXXXXXOXOXXXOXXXOXXXOXXXOXOXXXOXOXXXOXXXOXOXXXXXXXOXOXXXOXXXXXXXOXXXXXOXOXOXXXOXXXOXX
OXOOOOOOOOOXOOOXOOOOOXOXOOOOOOOOOXOOOOOXOXOXOOOXOXOOOXOXOOOXOXOOOOOXOOOXOXOXOXOOOXOXOXOXOOOOOOOOOXOOO
OXXXXXXXOXXXXXOXOXXXXXOXXXXXXXXXOXOXXXXXOXXXOXOXXXXXOXOXOXXXOXXXOXXXXXOXOXOXOXXXOXOXOXXXOXOXXXXXXXOXX
OOOOOOOXOOOXOXOOOOOXOXOXOXOOOOOOOXOOOXOXOXOOOXOXOOOXOXOOOXOOOXOOOXOOOOOOOXOOOOOOOOOOOOOXOXOOOOOXOXOXO
XXXXOXXXOXXXOXXXOXXXOXXXOXXXXXOXXXXXOXOXOXXXXXOXOXOXOXXXOXXXOXXXOXXXXXOXXXXXXXOXOXXXOXXXXXXXXXOXOXOXO
OOOOOXOOOXOXOOOXOOOOOXOOOOOOOOOXOXOOOXOOOXOOOOOXOXOOOOOXOOOXOXOXOOOXOXOOOOOXOXOXOXOOOOOOOXOXOXOOOXOOO
XXXXOXXXOXOXXXOXXXOXXXXXXXXXXXOXOXOXXXXXOXXXXXOXXXOXXXXXOXXXOXOXXXOXOXOXXXXXOXOXXXXXOXOXXXOXOXXXOXOXO
OOOOOOOOOOOOOXOOOXOOOXOOOOOOOOOOOXOOOXOXOOOOOOOXOOOOOXOOOOOXOOOOOOOXOXOOOOOOOOOOOXOXOXOOOOOXOXOXOXOXO
XXXXXXOXXXXXOXXXOXOXXXXXXXXXXXOXXXOXOXOXXXXXXXOXXXOXXXOXXXXXXXXXXXOXOXXXXXOXOXXXXXOXXXXXXXXXOXOXXXXXX
OXOXOOOXOXOXOOOOOOOOOOOOOXOOOOOOOXOXOXOXOOOOOOOXOOOXOOOXOOOOOXOXOXOOOXOOOXOXOXOXOOOOOOOOOOOOOOOXOXOOO
OXOXXXXXOXOXOXXXXXXXOXXXXXXXXXOXXXOXXXOXXXOXXXOXXXOXXXOXXXOXOXOXOXOXXXOXXXXXOXOXXXXXOXXXXXXXOXOXOXOXO
OOOOOOOOOOOXOXOOOOOOOOOXOOOOOOOOOXOOOOOXOXOXOXOXOOOOOOOXOXOXOOOXOOOXOXOXOOOOOOOXOXOXOOOXOOOXOXOXOXOXO
OXOXXXOXXXXXXXXXXXXXXXOXXXXXXXOXOXXXXXOXOXXXOXOXXXOXXXXXOXXXXXOXXXOXOXOXXXXXOXXXOXOXOXXXOXXXXXXXOXXXO
OXOXOXOXOXOOOOOXOOOOOOOOOXOXOXOXOXOOOXOOOXOOOOOXOOOOOXOOOOOXOOOXOOOXOOOOOXOOOXOOOXOOOXOXOOOXOOOOOXOOO
XXXXOXOXOXXXOXXXXXOXXXOXXXOXOXOXXXOXOXXXOXOXOXOXXXOXXXXXXXOXXXOXXXOXXXXXOXOXXXXXOXOXXXOXOXXXXXXXOXOXX
OOOOOOOXOOOXOXOOOXOXOXOOOXOXOOOXOOOXOOOOOXOXOXOOOXOOOXOOOOOXOOOOOOOOOXOOOOOOOOOOOOOOOOOXOXOXOXOOOXOOO
XXOXXXOXOXXXOXXXOXXXOXOXXXOXXXOXXXXXXXOXOXXXOXOXXXOXXXXXOXXXXXXXOXOXXXXXOXOXOXXXOXOXOXXXOXOXOXOXXXOXX
OOOOOXOOOXOOOOOOOOOXOXOOOXOOOOOOOXOOOXOXOOOXOXOOOOOXOXOOOXOOOOOXOXOXOXOOOXOXOOOXOXOXOXOOOOOXOXOOOXOOO
OXXXXXXXOXXXXXXXOXXXOXOXXXXXXXOXXXXXOXOXXXXXXXXXOXXXOXXXOXXXOXXXXXOXOXOXXXXXXXXXXXXXXXOXXXXXOXOXXXOXX
OXOOOXOXOOOXOOOOOOOOOOOOOOOOOXOXOOOOOOOXOXOXOXOOOOOXOXOXOXOOOXOOOOOOOOOXOXOXOXOXOXOOOXOXOXOOOOOOOXOOO
XXXXOXOXXXOXOXXXOXXXOXXXXXXXOXOXXXOXXXOXOXOXOXOXOXXXOXOXOXXXOXXXXXXXXXOXOXOXOXOXOXOXXXOXOXXXOXXXXXOXX
OOOOOOOOOOOOOXOOOOOXOXOOOOOOOOOXOXOXOXOXOOOXOOOXOXOOOOOOOOOOOXOOOOOOOXOOOXOOOXOXOXOOOXOXOOOXOOOXOXOOO
XXOXOXOXOXOXOXOXOXOXOXXXOXXXOXXXOXXXOXOXXXOXXXXXOXOXOXXXXXOXXXXXXXXXOXOXXXOXXXOXOXXXOXOXXXOXOXXXOXOXX
OXOXOXOXOXOXOXOXOXOXOXOOOXOOOOOXOXOXOOOOOXOXOOOOOXOXOXOXOOOOOXOOOXOXOOOXOOOXOXOOOOOXOOOOOOOOOOOOOXOOO
OXXXXXXXOXOXXXOXOXOXOXXXXXXXOXXXOXOXXXOXXXOXXXXXOXXXXXOXXXOXXXOXXXOXXXOXXXOXOXOXXXXXOXOXXXOXXXXXOXOXX
OXOOOXOXOXOXOOOXOXOXOOOXOOOOOOOOOOOXOXOOOOOOOOOXOOOOOXOXOXOXOOOXOXOXOOOXOXOOOOOOOOOXOXOOOXOOOOOXOOOOO
OXXXOXOXOXXXOXXXOXXXOXXXXXOXOXXXOXOXOXXXXXXXOXXXXXOXXXOXOXOXXXOXOXOXXXOXOXXXOXXXXXOXOXXXXXXXXXXXOXOXO
OOOOOOOOOOOXOXOOOOOXOXOOOXOXOXOXOXOOOOOOOOOOOOOOOXOXOXOOOOOOOOOOOOOOOOOOOOOOOOOOOXOXOXOOOOOXOXOXOXOXO
OXXXOXXXOXOXXXOXOXXXXXXXOXXXOXOXXXOXXXXXOXOXXXOXXXOXOXOXXXOXOXOXXXOXOXXXOXXXXXXXOXXXOXOXXXXXOXOXXXXXX
OOOXOXOOOXOXOXOXOOOOOXOOOOOOOOOXOXOXOOOXOXOOOXOOOOOOOOOXOXOXOXOOOXOXOXOOOOOOOOOXOXOOOXOXOXOOOXOOOXOXO
OXXXXXXXOXXXOXXXOXXXXXXXOXOXOXOXOXOXOXOXOXOXXXOXOXOXOXXXOXXXOXOXXXXXOXXXXXOXXXOXXXOXOXOXOXXXOXOXOXOXO
OXOOOOOOOOOOOXOOOOOXOOOOOXOXOXOXOOOXOXOOOXOOOXOXOXOXOOOXOOOXOXOOOXOOOOOOOXOOOXOOOXOXOXOOOXOOOOOXOXOOO
XXOXOXXXOXXXXXXXOXXXXXOXOXOXXXXXOXXXXXOXXXXXOXXXXXOXOXXXXXOXXXOXXXXXOXXXOXOXOXOXOXXXOXOXXXOXXXOXXXOXX
OXOXOXOOOOOOOXOOOXOXOXOXOXOXOOOOOXOOOOOXOOOOOXOXOOOXOOOXOXOOOOOXOOOOOOOXOXOXOXOXOXOOOOOOOXOOOXOOOXOXO
OXXXOXXXOXOXXXOXXXOXOXOXXXOXOXXXOXXXXXOXXXOXXXOXXXXXOXXXOXOXOXOXXXXXXXOXOXOXXXXXXXOXXXXXOXOXXXXXXXOXO
OOOOOXOOOXOOOXOXOOOOOOOXOOOXOOOXOOOXOOOXOOOXOXOOOOOOOOOXOOOXOXOOOOOXOXOXOXOOOOOOOOOOOXOOOOOOOOOOOOOOO
OXOXXXOXOXOXXXXXOXOXOXXXXXOXXXXXXXXXXXXXXXOXOXXXOXOXOXOXOXOXXXOXXXXXOXOXOXXXOXXXXXOXXXXXOXXXOXOXOXOXX
OXOXOOOXOXOOOXOOOXOXOXOXOOOOOOOXOOOOOOOOOOOXOOOOOXOXOXOXOXOXOOOOOXOOOXOXOOOXOOOOOXOOOOOXOOOXOXOXOXOOO
OXXXOXOXOXOXOXXXOXXXOXOXOXXXXXOXXXXXOXOXXXOXXXXXOXXXOXXXXXOXXXOXXXXXOXXXXXOXOXOXXXOXXXXXXXOXXXOXXXOXX
OXOOOXOXOXOXOXOOOOOXOXOOOXOXOXOXOOOOOXOXOXOXOOOOOXOXOOOOOXOXOOOOOOOOOOOXOXOXOXOXOOOOOOOXOXOXOOOXOOOOO
XXOXXXXXOXOXXXOXOXXXOXOXXXOXOXXXXXXXXXOXOXOXXXOXXXOXOXOXXXOXOXOXOXXXXXXXOXXXOXXXXXOXXXOXOXXXXXOXOXOXX
OXOOOXOOOXOXOOOXOXOXOXOOOXOOOOOOOOOOOOOXOOOOOXOOOOOXOXOXOOOXOXOXOOOOOOOXOXOOOOOOOXOXOOOOOOOOOXOXOXOOO
OXXXXXXXXXXXOXXXOXOXXXXXXXOXXXXXXXOXXXOXOXOXXXXXOXOXOXXXXXXXXXOXOXXXOXXXOXXXOXOXOXOXOXOXXXOXXXOXXXOXX
OOOOOOOXOOOOOXOOOXOXOOOOOOOXOOOOOOOXOXOXOXOXOOOXOXOXOOOXOXOOOOOXOXOOOOOXOXOOOXOXOXOXOXOXOXOXOOOXOOOXO
OXXXXXOXOXXXXXXXXXOXXXOXXXOXOXOXXXOXOXXXXXXXXXOXXXOXOXXXOXXXOXOXOXXXOXXXOXXXOXXXXXXXXXOXOXOXXXOXOXOXO
OXOOOOOOOOOXOOOOOOOOOOOOOXOXOXOXOOOOOOOOOXOOOOOOOOOXOOOOOOOXOXOXOOOXOOOOOXOXOOOXOOOXOOOXOOOXOOOXOXOOO
OXOXXXXXOXXXOXXXXXXXOXOXXXXXOXXXXXOXXXOXXXXXOXXXOXXXOXOXXXXXOXOXOXXXOXOXOXOXXXXXOXXXOXXXOXXXXXOXXXXXO
OXOOOXOXOOOXOXOOOXOOOXOOOXOOOXOXOOOXOOOXOOOOOXOOOOOXOXOOOXOOOXOXOXOOOXOXOOOOOOOOOXOXOXOXOOOOOXOOOXOXO
XXOXXXOXOXXXOXOXXXXXOXXXXXXXOXOXOXOXXXXXXXOXXXOXOXOXOXOXXXXXOXOXOXXXXXXXXXXXXXOXOXOXXXOXOXXXOXOXOXOXO
OOOXOOOOOXOXOXOOOOOOOXOOOOOXOXOOOXOOOOOXOOOOOXOXOXOXOXOOOXOOOXOXOOOOOOOOOOOOOXOXOXOOOOOOOOOXOXOXOXOOO
OXOXXXOXOXOXOXOXXXOXOXXXXXOXOXXXXXXXOXXXOXXXOXOXXXXXXXOXOXXXOXOXXXOXXXXXXXOXXXOXXXOXOXXXOXXXXXOXXXOXO
OXOXOOOXOXOXOXOOOXOXOXOOOOOOOOOOOXOOOOOXOXOXOXOXOOOXOOOXOOOXOXOXOOOOOOOOOXOOOXOOOXOXOXOOOOOOOXOOOXOXO
OXOXXXXXOXOXXXOXXXOXOXOXXXOXOXOXOXOXOXOXXXOXXXOXXXOXXXXXOXXXOXXXXXOXXXOXXXXXXXOXOXXXOXXXOXXXXXOXXXXXO
OXOXOOOXOXOOOOOXOOOXOXOXOXOXOXOXOXOXOXOOOXOOOOOOOXOOOOOOOOOXOXOOOOOXOOOXOXOOOXOXOOOXOXOOOOOXOOOOOXOXO
OXOXXXOXXXXXOXOXXXXXXXXXOXOXXXXXOXXXOXOXXXOXOXOXXXXXOXOXXXOXOXXXOXOXXXXXOXXXOXXXXXXXOXOXOXXXXXOXXXOXO
OXOXOOOOOXOXOXOXOOOOOOOOOOOOOXOOOXOXOXOXOOOXOXOXOOOOOXOOOXOXOXOXOXOOOXOOOOOOOOOOOXOOOXOXOXOOOOOOOXOOO
XXOXOXXXOXOXXXXXOXOXOXXXXXOXXXXXXXOXXXXXXXXXXXOXXXOXOXXXXXXXXXOXXXOXXXOXXXXXOXXXXXXXXXOXXXXXOXOXOXXXO
OOOXOOOXOOOOOOOOOXOXOXOXOOOOOOOOOXOOOOOOOXOXOOOXOOOXOOOOOXOXOOOXOOOOOOOOOOOXOOOXOOOXOOOOOXOOOXOXOOOXO
XXXXOXXXXXXXXXXXOXXXXXOXOXXXOXXXXXXXOXOXXXOXOXOXXXXXOXXXXXOXXXOXOXOXXXOXOXXXOXXXOXXXXXOXXXXXXXXXOXOXO
OOOOOOOXOOOOOXOOOXOXOXOOOOOXOOOOOXOOOXOOOOOOOXOXOOOOOOOOOXOOOOOOOXOXOXOXOXOXOOOXOXOOOXOXOXOXOOOXOXOXO
OXOXXXXXXXXXOXOXOXOXOXXXOXXXOXXXXXOXOXXXXXOXXXXXOXXXOXOXXXXXXXOXXXOXOXOXXXOXOXXXOXOXXXOXOXOXOXXXOXOXO
OXOXOOOOOOOOOOOXOXOOOOOOOXOOOOOOOXOXOXOOOOOOOOOXOOOXOXOXOOOOOOOOOXOXOOOOOXOOOOOOOOOXOOOOOOOOOOOXOXOXOZ
